%%%%%%%
%   %%%
% % %%%
% %P .%
% % % %
%     %
%%%%%%%
